//MAP CONVERTED BY dmm2tgm.py THIS HEADER COMMENT PREVENTS RECONVERSION, DO NOT REMOVE
"aa" = (
/turf/closed/mineral/rogue/bedrock,
/area/rogue/under/tomb/cave/wet)
"ab" = (
/turf/open/floor/rogue/cobble/mossy,
/area/rogue/under/tomb/cave/wet)
"ac" = (
/turf/open/floor/rogue/tile/masonic/spiral,
/area/rogue/under/tomb/indoors/magic)
"ad" = (
/turf/closed/wall/mineral/rogue/stonebrick,
/area/rogue/under/tomb/indoors/magic)
"ae" = (
/obj/effect/dungeon_directional_helper/north,
/turf/open/floor/rogue/tile/masonic/spiral,
/area/rogue/under/tomb/indoors/magic)
"af" = (
/obj/effect/dungeon_directional_helper/south,
/turf/open/floor/rogue/tile/masonic/spiral,
/area/rogue/under/tomb/indoors/magic)
"ag" = (
/obj/effect/dungeon_directional_helper/west,
/turf/open/floor/rogue/tile/masonic/spiral,
/area/rogue/under/tomb/indoors/magic)
"ah" = (
/obj/effect/dungeon_directional_helper/east,
/turf/open/floor/rogue/tile/masonic/spiral,
/area/rogue/under/tomb/indoors/magic)
"ai" = (
/obj/structure/bookcase/random,
/turf/open/floor/rogue/tile/masonic/spiral,
/area/rogue/under/tomb/indoors/magic)
"aj" = (
/obj/structure/table/wood,
/obj/item/alch/runedust,
/turf/open/floor/rogue/tile/masonic/spiral,
/area/rogue/under/tomb/indoors/magic)
"ak" = (
/mob/living/carbon/human/species/skeleton/npc/hardspread,
/turf/open/floor/rogue/tile/masonic/spiral,
/area/rogue/under/tomb/indoors/magic)
"al" = (
/obj/machinery/light/rogue/candle/blue,
/turf/open/floor/rogue/tile/masonic/spiral,
/area/rogue/under/tomb/indoors/magic)
"am" = (
/obj/structure/trap/chill,
/turf/open/floor/rogue/tile/masonic/spiral,
/area/rogue/under/tomb/indoors/magic)
"an" = (
/turf/open/lava/acid,
/area/rogue/under/tomb/cave/wet)
"ao" = (
/turf/open/transparent/openspace,
/area/rogue/under/tomb/indoors/magic)
"ap" = (
/turf/closed/wall/mineral/rogue/decostone,
/area/rogue/under/tomb/indoors/magic)

(1,1,1) = {"
aa
aa
aa
aa
aa
aa
aa
aa
aa
aa
aa
aa
aa
aa
ag
ac
ac
aa
aa
aa
aa
aa
aa
aa
aa
aa
aa
aa
aa
aa
"}
(2,1,1) = {"
aa
aa
aa
aa
aa
aa
aa
aa
aa
aa
aa
aa
aa
ac
ac
ac
ac
ac
aa
aa
aa
aa
aa
aa
aa
aa
aa
aa
aa
aa
"}
(3,1,1) = {"
aa
aa
an
an
an
an
an
an
an
an
an
an
an
ac
ac
ac
ac
ac
an
an
an
an
an
an
an
an
an
an
aa
aa
"}
(4,1,1) = {"
aa
aa
an
ad
ad
ad
ad
ad
ad
ad
ad
ad
ad
ad
ad
ad
ad
ad
ad
ad
ad
ad
ad
ad
ad
ad
an
an
aa
aa
"}
(5,1,1) = {"
aa
aa
an
ad
ai
ac
ac
al
ac
ac
ac
ac
ac
ac
ac
ac
ac
ac
ac
ac
al
ac
ac
ai
ad
ad
an
an
aa
aa
"}
(6,1,1) = {"
aa
aa
an
ad
ac
ac
ac
ac
ac
ac
ac
ac
ac
ac
ac
ac
ac
ac
ac
ac
ac
ac
ac
ac
ad
ad
an
an
aa
aa
"}
(7,1,1) = {"
aa
aa
an
ad
ac
ac
ap
ap
ap
ap
ac
ac
ac
ac
ac
ac
ac
ac
ac
ac
ap
ap
ap
ac
ad
ad
an
an
aa
aa
"}
(8,1,1) = {"
aa
aa
an
ad
al
ac
ap
aj
aj
ap
ac
ac
ac
ak
ac
ac
ac
ac
ac
ac
ap
aj
ap
ac
ad
ad
an
an
aa
aa
"}
(9,1,1) = {"
aa
aa
an
ad
ac
ac
ap
ac
ac
ap
ac
ac
ac
ac
ac
ac
ac
ac
ac
ac
ap
ac
ap
ac
ad
ad
an
an
aa
aa
"}
(10,1,1) = {"
aa
aa
an
ad
ac
ac
ap
ap
ap
ap
ac
ac
ak
ac
ac
ac
ac
ac
ac
ac
ap
ap
ap
ac
ad
ad
an
an
aa
aa
"}
(11,1,1) = {"
ae
ac
ac
ac
ac
ac
ac
ac
ac
ac
ac
ac
ac
ac
ac
ac
ac
ac
ac
ac
ac
ac
ac
ac
ac
ac
ac
ac
ac
af
"}
(12,1,1) = {"
ac
ac
ac
ac
ac
ac
ac
ac
ac
ac
ac
ac
ac
ac
ac
ac
ac
ac
ac
ac
ac
ac
ac
ac
ac
ac
ac
ac
ac
ac
"}
(13,1,1) = {"
ac
ac
ac
ac
ac
ac
ac
ac
ac
ac
ac
ac
ac
ac
ac
ac
ac
ac
ac
ac
ac
ac
ac
ac
ac
ac
ac
ac
ac
ac
"}
(14,1,1) = {"
aa
aa
an
ad
ac
ac
ac
ac
ac
ac
ac
ac
ac
ac
ac
ac
ac
ac
ac
ac
ac
ac
ac
ac
ad
ad
an
an
aa
aa
"}
(15,1,1) = {"
aa
aa
an
ad
ac
ac
ac
ac
ac
ac
ac
ac
ac
ac
ac
ac
ac
ac
ac
ac
ac
ac
ac
ac
ad
ad
an
an
aa
aa
"}
(16,1,1) = {"
aa
aa
an
ad
ac
ac
ac
ac
ac
ac
ac
ac
ac
ac
ac
ac
ac
ac
ac
ac
ac
ac
ac
ac
ad
ad
an
an
aa
aa
"}
(17,1,1) = {"
aa
aa
an
ad
ac
ac
ap
ap
ap
ap
ac
ac
ac
ac
ac
ac
ac
ac
ac
ac
ap
ap
ap
ac
ad
ad
an
an
aa
aa
"}
(18,1,1) = {"
aa
aa
an
ad
ac
ac
ap
ac
ac
ap
ac
ac
ac
ac
ac
ac
ac
ac
ac
ac
ap
ac
ap
ac
ad
ad
an
an
aa
aa
"}
(19,1,1) = {"
aa
aa
an
ad
al
ac
ap
ak
ac
ap
ac
ac
ac
ac
al
ac
ac
ac
ac
ac
ap
ac
ap
ac
ad
ad
an
an
aa
aa
"}
(20,1,1) = {"
aa
aa
an
ad
ac
ac
ap
ap
ap
ap
ac
ac
ac
ac
ac
ac
ac
ac
ac
ac
ap
ap
ap
ac
ad
ad
an
an
aa
aa
"}
(21,1,1) = {"
aa
aa
an
ad
ac
ac
ac
ac
ac
ac
ac
ac
ac
ac
ac
ac
ac
ac
ac
ac
ac
ac
ac
ac
ad
ad
an
an
aa
aa
"}
(22,1,1) = {"
aa
aa
an
ad
ac
ac
ac
ac
ac
ac
ac
ac
ac
ac
ac
ac
ac
ac
ac
ac
ac
ac
ac
ac
ad
ad
an
an
aa
aa
"}
(23,1,1) = {"
aa
aa
an
ad
ai
ac
ac
ac
ac
ac
ac
ac
ac
ac
ac
ac
ac
ac
ac
ac
ac
ac
ac
ai
ad
ad
an
an
aa
aa
"}
(24,1,1) = {"
aa
aa
an
ad
ad
ad
ad
ad
ad
ad
ad
ad
ad
ad
ad
ad
ad
ad
ad
ad
ad
ad
ad
ad
ad
ad
an
an
aa
aa
"}
(25,1,1) = {"
aa
aa
an
an
an
an
an
an
an
an
an
an
an
ac
ac
ac
ac
ac
an
an
an
an
an
an
an
an
an
an
aa
aa
"}
(26,1,1) = {"
aa
aa
aa
aa
aa
aa
aa
aa
aa
aa
aa
aa
aa
ac
ac
ac
ac
ac
aa
aa
aa
aa
aa
aa
aa
aa
aa
aa
aa
aa
"}
(27,1,1) = {"
aa
aa
aa
aa
aa
aa
aa
aa
aa
aa
aa
aa
aa
aa
ah
ac
ac
aa
aa
aa
aa
aa
aa
aa
aa
aa
aa
aa
aa
aa
"}
(28,1,1) = {"
aa
aa
aa
aa
aa
aa
aa
aa
aa
aa
aa
aa
aa
aa
aa
aa
aa
aa
aa
aa
aa
aa
aa
aa
aa
aa
aa
aa
aa
aa
"}
(29,1,1) = {"
aa
aa
aa
aa
aa
aa
aa
aa
aa
aa
aa
aa
aa
aa
aa
aa
aa
aa
aa
aa
aa
aa
aa
aa
aa
aa
aa
aa
aa
aa
"}
(30,1,1) = {"
aa
aa
aa
aa
aa
aa
aa
aa
aa
aa
aa
aa
aa
aa
aa
aa
aa
aa
aa
aa
aa
aa
aa
aa
aa
aa
aa
aa
aa
aa
"}

(1,1,2) = {"
aa
aa
aa
aa
aa
aa
aa
aa
aa
aa
aa
aa
aa
aa
ao
ao
ao
aa
aa
aa
aa
aa
aa
aa
aa
aa
aa
aa
aa
aa
"}
(2,1,2) = {"
aa
aa
aa
aa
aa
aa
aa
aa
aa
aa
aa
aa
aa
ao
ao
ao
ao
ao
aa
aa
aa
aa
aa
aa
aa
aa
aa
aa
aa
aa
"}
(3,1,2) = {"
aa
aa
ao
ao
ao
ao
ao
ao
ao
ao
ao
ao
ao
ao
ao
ao
ao
ao
ao
ao
ao
ao
ao
ao
ao
ao
ao
ao
aa
aa
"}
(4,1,2) = {"
aa
aa
ao
ad
ad
ad
ad
ad
ad
ad
ad
ad
ad
ad
ad
ad
ad
ad
ad
ad
ad
ad
ad
ad
ad
ad
ao
ao
aa
aa
"}
(5,1,2) = {"
aa
aa
ao
ad
ao
ao
ao
ao
ao
ao
ao
ao
ao
ao
ao
ao
ao
ao
ao
ao
ao
ao
ao
ao
ad
ad
ao
ao
aa
aa
"}
(6,1,2) = {"
aa
aa
ao
ad
ao
ao
ao
ao
ao
ao
ao
ao
ao
ao
ao
ao
ao
ao
ao
ao
ao
ao
ao
ao
ad
ad
ao
ao
aa
aa
"}
(7,1,2) = {"
aa
aa
ao
ad
ao
ao
ap
ap
ap
ap
ao
ao
ao
ao
ao
ao
ao
ao
ao
ao
ap
ap
ap
ao
ad
ad
ao
ao
aa
aa
"}
(11,1,2) = {"
ao
ao
ao
ao
ao
ao
ao
ao
ao
ao
ao
ao
ao
ao
ao
ao
ao
ao
ao
ao
ao
ao
ao
ao
ao
ao
ao
ao
ao
ao
"}
(30,1,2) = {"
aa
aa
aa
aa
aa
aa
aa
aa
aa
aa
aa
aa
aa
aa
aa
aa
aa
aa
aa
aa
aa
aa
aa
aa
aa
aa
aa
aa
aa
aa
"}
